NO ./images/wallN.xpm
SO ./images/wallS.xpm
WE ./images/wallW.xpm
EA ./images/wallE.xpm

F 255,255,25
C 144,144,252

11111111111
10000000001
10000000001
10000000001
10000000001
10000000001
10000000001
10000000001
10000000001
10000000001
10000N00001
10000000001
10000000001
10000000001
10000000001
10000000001
10000000001
10000000001
10000000001
10000000001
10000000001
11111111111