


NO    ./images/no.xpm
SO    ./images/so.xpm


WE ./images/we.xpm




EA ./images/ea.xpm



F                                    255,255,25





C      144,144,252

111111111111111111111111111111111
111111111111111111111111111111111111111111111111111
100000000000000000000000000000000000000000000000001
100000000000000000000000000000000000000000000000001
111111111111111111111111111111111111111111111111111
1000000001 1000000000100000000001
1000000001110000N0000110000000001
1000111111000000000001100000000011
10000000000000000000001000000000011111111111111
111111111111111111111111111111111111111111111111111111111111111111
111111111111111111111111111111111111111111111111111111111111111111
1000000001000000000000100000000001                               
1000000011100000000000100000000001                               
1000000111110000010000000000000001                               
1000000011100000000000100000000001                               
1000000001000000000000100000000001                               
1000000000000000000000100000000001                               
111111111111111111111111111111111111111111111111111111111111111111

