NO ./images/wall_n.xpm
SO ./images/wall_s.xpm
WE ./images/wall_w.xpm
EA ./images/wall_e.xpm



C                                  0,204,204





F      0,204,2

111111111111111111111111111111111
111111111111111111111111111111111111111111111111111
100000000000000000000000000000000000000000000000001
100000000000000000000000000000000000000000000000001
11111111111110000000000000011111111111111111111111111111111111111111111111
1000000001 100000000000000000000000000000000000000000001
1000000001110000000N000000000000000000000000000000000001
100011111100000000000000000000000000000000000000000000011
1000000000000000000000000000000000000000000000000000000011111111111111
11111111111110000000000000011111111111111111111111111111111111111111111111111111111111111
111111111111100000000000000111111111111111111111111111111111111111
1000000001000000000000100000000001                               
1000000011100000000000100000000001                               
1000000111110000010000000000000001                               
1000000011100000000000100000000001                               
1000000001000000000000100000000001                               
1000000000000000000000100000000001                               
111111111111111111111111111111111111111111111111111111111111111111

