1111111111111111111111111111111111111
1000000000000000000100100000000001001
1000000000000000000100100000000001001
1000000000000000000000000000000001001
1000000000000000000100100000000001001
1000000000000000000100100000000000001
1000000000000000111100111100000001001
1111110111111111100000000111111111001
1000000000000000000000000000000001001
1000000000000000000000000000000001001
1111110111111111100000000111111111001
1000000000000000011100111100000000001
1000000000000000000100100000000001001
1000000000000000000100100000000001001
1000000000000000000000000000000001001
1000000000000000000100100000000001001
10000000000000000001001000000000010N1
1111111111111111111111111111111111111
