1111111111111111111111111111111111111
1000000000000000000100100000000001001
10000000000000N0000100100000000001001
100000001000000000F00F00000000001001
1000000000000000000100100000000001001
100000000000000000010010000000000F001
1000000000000000112100111100000001001
111111F112121111100000000111111111001
1000000000000000000110000000000000001
1000000000000000000F2000000000010011
111111F11112113110011000111111111001
100000000000000001110011110000000F001
1000000000000000000100100000000001001
1000000000000000000100100000000001001
1011111000000000000000000F00F000000001
1000000000000000000100100000000000011
1000000000000000000100100000000001011
1111111111111111111111111111111111111
121
 11
    
  