1111111111111111111111111111111111111
1000000000000000000100100000000001001
1000000000000000000100100000000001001
1000000000000000000F00F00000000001001
1000000000000000000100100000000001001
100000000000000000010010000000000F001
1000000000000000111100111100000001001
111111F111111111100000000111111111001
1000000000000000000000000000000001001
100000000000000000N000000000000001001
111111F111111111100000000111111111001
100000000000000001110011110000000F001
1000000000000000000100100000000001001
1000000000000000000100100000000001001
1000000000000000000F00F00000000001001
1000000000000000000100100000000001001
1000000000000000000100100000000001001
1111111111111111111111111111111111111