111111
 10N01 1
 1001  1
11111  1